00000000
000  000
0000000s
0000000s
0000000s
00000b00
00000B00
00000000

00000000
0M000R00
00000r00
00000000
000X0000
00000000
0SP000P0
00000000